static const String alien = "assets/svg/wi-alien.svg";
static const String barometer = "assets/svg/wi-barometer.svg";
static const String celsius = "assets/svg/wi-celsius.svg";
static const String cloudDown = "assets/svg/wi-cloud-down.svg";
static const String cloudRefresh = "assets/svg/wi-cloud-refresh.svg";
static const String cloudUp = "assets/svg/wi-cloud-up.svg";
static const String cloud = "assets/svg/wi-cloud.svg";
static const String cloudyGusts = "assets/svg/wi-cloudy-gusts.svg";
static const String cloudyWindy = "assets/svg/wi-cloudy-windy.svg";
static const String cloudy = "assets/svg/wi-cloudy.svg";
static const String dayCloudyGusts = "assets/svg/wi-day-cloudy-gusts.svg";
static const String dayCloudyHigh = "assets/svg/wi-day-cloudy-high.svg";
static const String dayCloudyWindy = "assets/svg/wi-day-cloudy-windy.svg";
static const String dayCloudy = "assets/svg/wi-day-cloudy.svg";
static const String dayFog = "assets/svg/wi-day-fog.svg";
static const String dayHail = "assets/svg/wi-day-hail.svg";
static const String dayHaze = "assets/svg/wi-day-haze.svg";
static const String dayLightWind = "assets/svg/wi-day-light-wind.svg";
static const String dayLightning = "assets/svg/wi-day-lightning.svg";
static const String dayRainMix = "assets/svg/wi-day-rain-mix.svg";
static const String dayRainWind = "assets/svg/wi-day-rain-wind.svg";
static const String dayRain = "assets/svg/wi-day-rain.svg";
static const String dayShowers = "assets/svg/wi-day-showers.svg";
static const String daySleetStorm = "assets/svg/wi-day-sleet-storm.svg";
static const String daySleet = "assets/svg/wi-day-sleet.svg";
static const String daySnowThunderstorm = "assets/svg/wi-day-snow-thunderstorm.svg";
static const String daySnowWind = "assets/svg/wi-day-snow-wind.svg";
static const String daySnow = "assets/svg/wi-day-snow.svg";
static const String daySprinkle = "assets/svg/wi-day-sprinkle.svg";
static const String dayStormShowers = "assets/svg/wi-day-storm-showers.svg";
static const String daySunnyOvercast = "assets/svg/wi-day-sunny-overcast.svg";
static const String daySunny = "assets/svg/wi-day-sunny.svg";
static const String dayThunderstorm = "assets/svg/wi-day-thunderstorm.svg";
static const String dayWindy = "assets/svg/wi-day-windy.svg";
static const String degrees = "assets/svg/wi-degrees.svg";
static const String directionDownLeft = "assets/svg/wi-direction-down-left.svg";
static const String directionDownRight = "assets/svg/wi-direction-down-right.svg";
static const String directionDown = "assets/svg/wi-direction-down.svg";
static const String directionLeft = "assets/svg/wi-direction-left.svg";
static const String directionRight = "assets/svg/wi-direction-right.svg";
static const String directionUpLeft = "assets/svg/wi-direction-up-left.svg";
static const String directionUpRight = "assets/svg/wi-direction-up-right.svg";
static const String directionUp = "assets/svg/wi-direction-up.svg";
static const String dust = "assets/svg/wi-dust.svg";
static const String earthquake = "assets/svg/wi-earthquake.svg";
static const String fahrenheit = "assets/svg/wi-fahrenheit.svg";
static const String fire = "assets/svg/wi-fire.svg";
static const String flood = "assets/svg/wi-flood.svg";
static const String fog = "assets/svg/wi-fog.svg";
static const String galeWarning = "assets/svg/wi-gale-warning.svg";
static const String hail = "assets/svg/wi-hail.svg";
static const String horizonAlt = "assets/svg/wi-horizon-alt.svg";
static const String horizon = "assets/svg/wi-horizon.svg";
static const String hot = "assets/svg/wi-hot.svg";
static const String humidity = "assets/svg/wi-humidity.svg";
static const String hurricaneWarning = "assets/svg/wi-hurricane-warning.svg";
static const String hurricane = "assets/svg/wi-hurricane.svg";
static const String lightning = "assets/svg/wi-lightning.svg";
static const String lunarEclipse = "assets/svg/wi-lunar-eclipse.svg";
static const String meteor = "assets/svg/wi-meteor.svg";
static const String moonAltFirstQuarter = "assets/svg/wi-moon-alt-first-quarter.svg";
static const String moonAltFull = "assets/svg/wi-moon-alt-full.svg";
static const String moonAltNew = "assets/svg/wi-moon-alt-new.svg";
static const String moonAltThirdQuarter = "assets/svg/wi-moon-alt-third-quarter.svg";
static const String moonAltWaningCrescent1 = "assets/svg/wi-moon-alt-waning-crescent-1.svg";
static const String moonAltWaningCrescent2 = "assets/svg/wi-moon-alt-waning-crescent-2.svg";
static const String moonAltWaningCrescent3 = "assets/svg/wi-moon-alt-waning-crescent-3.svg";
static const String moonAltWaningCrescent4 = "assets/svg/wi-moon-alt-waning-crescent-4.svg";
static const String moonAltWaningCrescent5 = "assets/svg/wi-moon-alt-waning-crescent-5.svg";
static const String moonAltWaningCrescent6 = "assets/svg/wi-moon-alt-waning-crescent-6.svg";
static const String moonAltWaningGibbous1 = "assets/svg/wi-moon-alt-waning-gibbous-1.svg";
static const String moonAltWaningGibbous2 = "assets/svg/wi-moon-alt-waning-gibbous-2.svg";
static const String moonAltWaningGibbous3 = "assets/svg/wi-moon-alt-waning-gibbous-3.svg";
static const String moonAltWaningGibbous4 = "assets/svg/wi-moon-alt-waning-gibbous-4.svg";
static const String moonAltWaningGibbous5 = "assets/svg/wi-moon-alt-waning-gibbous-5.svg";
static const String moonAltWaningGibbous6 = "assets/svg/wi-moon-alt-waning-gibbous-6.svg";
static const String moonAltWaxingCrescent1 = "assets/svg/wi-moon-alt-waxing-crescent-1.svg";
static const String moonAltWaxingCrescent2 = "assets/svg/wi-moon-alt-waxing-crescent-2.svg";
static const String moonAltWaxingCrescent3 = "assets/svg/wi-moon-alt-waxing-crescent-3.svg";
static const String moonAltWaxingCrescent4 = "assets/svg/wi-moon-alt-waxing-crescent-4.svg";
static const String moonAltWaxingCrescent5 = "assets/svg/wi-moon-alt-waxing-crescent-5.svg";
static const String moonAltWaxingCrescent6 = "assets/svg/wi-moon-alt-waxing-crescent-6.svg";
static const String moonAltWaxingGibbous1 = "assets/svg/wi-moon-alt-waxing-gibbous-1.svg";
static const String moonAltWaxingGibbous2 = "assets/svg/wi-moon-alt-waxing-gibbous-2.svg";
static const String moonAltWaxingGibbous3 = "assets/svg/wi-moon-alt-waxing-gibbous-3.svg";
static const String moonAltWaxingGibbous4 = "assets/svg/wi-moon-alt-waxing-gibbous-4.svg";
static const String moonAltWaxingGibbous5 = "assets/svg/wi-moon-alt-waxing-gibbous-5.svg";
static const String moonAltWaxingGibbous6 = "assets/svg/wi-moon-alt-waxing-gibbous-6.svg";
static const String moonFirstQuarter = "assets/svg/wi-moon-first-quarter.svg";
static const String moonFull = "assets/svg/wi-moon-full.svg";
static const String moonNew = "assets/svg/wi-moon-new.svg";
static const String moonThirdQuarter = "assets/svg/wi-moon-third-quarter.svg";
static const String moonWaningCrescent1 = "assets/svg/wi-moon-waning-crescent-1.svg";
static const String moonWaningCrescent2 = "assets/svg/wi-moon-waning-crescent-2.svg";
static const String moonWaningCrescent3 = "assets/svg/wi-moon-waning-crescent-3.svg";
static const String moonWaningCrescent4 = "assets/svg/wi-moon-waning-crescent-4.svg";
static const String moonWaningCrescent5 = "assets/svg/wi-moon-waning-crescent-5.svg";
static const String moonWaningCrescent6 = "assets/svg/wi-moon-waning-crescent-6.svg";
static const String moonWaningGibbous1 = "assets/svg/wi-moon-waning-gibbous-1.svg";
static const String moonWaningGibbous2 = "assets/svg/wi-moon-waning-gibbous-2.svg";
static const String moonWaningGibbous3 = "assets/svg/wi-moon-waning-gibbous-3.svg";
static const String moonWaningGibbous4 = "assets/svg/wi-moon-waning-gibbous-4.svg";
static const String moonWaningGibbous5 = "assets/svg/wi-moon-waning-gibbous-5.svg";
static const String moonWaningGibbous6 = "assets/svg/wi-moon-waning-gibbous-6.svg";
static const String moonWaxing6 = "assets/svg/wi-moon-waxing-6.svg";
static const String moonWaxingCrescent1 = "assets/svg/wi-moon-waxing-crescent-1.svg";
static const String moonWaxingCrescent2 = "assets/svg/wi-moon-waxing-crescent-2.svg";
static const String moonWaxingCrescent3 = "assets/svg/wi-moon-waxing-crescent-3.svg";
static const String moonWaxingCrescent4 = "assets/svg/wi-moon-waxing-crescent-4.svg";
static const String moonWaxingCrescent5 = "assets/svg/wi-moon-waxing-crescent-5.svg";
static const String moonWaxingGibbous1 = "assets/svg/wi-moon-waxing-gibbous-1.svg";
static const String moonWaxingGibbous2 = "assets/svg/wi-moon-waxing-gibbous-2.svg";
static const String moonWaxingGibbous3 = "assets/svg/wi-moon-waxing-gibbous-3.svg";
static const String moonWaxingGibbous4 = "assets/svg/wi-moon-waxing-gibbous-4.svg";
static const String moonWaxingGibbous5 = "assets/svg/wi-moon-waxing-gibbous-5.svg";
static const String moonWaxingGibbous6 = "assets/svg/wi-moon-waxing-gibbous-6.svg";
static const String moonrise = "assets/svg/wi-moonrise.svg";
static const String moonset = "assets/svg/wi-moonset.svg";
static const String na = "assets/svg/wi-na.svg";
static const String nightAltCloudyGusts = "assets/svg/wi-night-alt-cloudy-gusts.svg";
static const String nightAltCloudyHigh = "assets/svg/wi-night-alt-cloudy-high.svg";
static const String nightAltCloudyWindy = "assets/svg/wi-night-alt-cloudy-windy.svg";
static const String nightAltCloudy = "assets/svg/wi-night-alt-cloudy.svg";
static const String nightAltHail = "assets/svg/wi-night-alt-hail.svg";
static const String nightAltLightning = "assets/svg/wi-night-alt-lightning.svg";
static const String nightAltPartlyCloudy = "assets/svg/wi-night-alt-partly-cloudy.svg";
static const String nightAltRainMix = "assets/svg/wi-night-alt-rain-mix.svg";
static const String nightAltRainWind = "assets/svg/wi-night-alt-rain-wind.svg";
static const String nightAltRain = "assets/svg/wi-night-alt-rain.svg";
static const String nightAltShowers = "assets/svg/wi-night-alt-showers.svg";
static const String nightAltSleetStorm = "assets/svg/wi-night-alt-sleet-storm.svg";
static const String nightAltSleet = "assets/svg/wi-night-alt-sleet.svg";
static const String nightAltSnowThunderstorm = "assets/svg/wi-night-alt-snow-thunderstorm.svg";
static const String nightAltSnowWind = "assets/svg/wi-night-alt-snow-wind.svg";
static const String nightAltSnow = "assets/svg/wi-night-alt-snow.svg";
static const String nightAltSprinkle = "assets/svg/wi-night-alt-sprinkle.svg";
static const String nightAltStormShowers = "assets/svg/wi-night-alt-storm-showers.svg";
static const String nightAltThunderstorm = "assets/svg/wi-night-alt-thunderstorm.svg";
static const String nightClear = "assets/svg/wi-night-clear.svg";
static const String nightCloudyGusts = "assets/svg/wi-night-cloudy-gusts.svg";
static const String nightCloudyHigh = "assets/svg/wi-night-cloudy-high.svg";
static const String nightCloudyWindy = "assets/svg/wi-night-cloudy-windy.svg";
static const String nightCloudy = "assets/svg/wi-night-cloudy.svg";
static const String nightFog = "assets/svg/wi-night-fog.svg";
static const String nightHail = "assets/svg/wi-night-hail.svg";
static const String nightLightning = "assets/svg/wi-night-lightning.svg";
static const String nightPartlyCloudy = "assets/svg/wi-night-partly-cloudy.svg";
static const String nightRainMix = "assets/svg/wi-night-rain-mix.svg";
static const String nightRainWind = "assets/svg/wi-night-rain-wind.svg";
static const String nightRain = "assets/svg/wi-night-rain.svg";
static const String nightShowers = "assets/svg/wi-night-showers.svg";
static const String nightSleetStorm = "assets/svg/wi-night-sleet-storm.svg";
static const String nightSleet = "assets/svg/wi-night-sleet.svg";
static const String nightSnowThunderstorm = "assets/svg/wi-night-snow-thunderstorm.svg";
static const String nightSnowWind = "assets/svg/wi-night-snow-wind.svg";
static const String nightSnow = "assets/svg/wi-night-snow.svg";
static const String nightSprinkle = "assets/svg/wi-night-sprinkle.svg";
static const String nightStormShowers = "assets/svg/wi-night-storm-showers.svg";
static const String nightThunderstorm = "assets/svg/wi-night-thunderstorm.svg";
static const String rainMix = "assets/svg/wi-rain-mix.svg";
static const String rainWind = "assets/svg/wi-rain-wind.svg";
static const String rain = "assets/svg/wi-rain.svg";
static const String raindrop = "assets/svg/wi-raindrop.svg";
static const String raindrops = "assets/svg/wi-raindrops.svg";
static const String refreshAlt = "assets/svg/wi-refresh-alt.svg";
static const String refresh = "assets/svg/wi-refresh.svg";
static const String sandstorm = "assets/svg/wi-sandstorm.svg";
static const String showers = "assets/svg/wi-showers.svg";
static const String sleet = "assets/svg/wi-sleet.svg";
static const String smallCraftAdvisory = "assets/svg/wi-small-craft-advisory.svg";
static const String smog = "assets/svg/wi-smog.svg";
static const String smoke = "assets/svg/wi-smoke.svg";
static const String snowWind = "assets/svg/wi-snow-wind.svg";
static const String snow = "assets/svg/wi-snow.svg";
static const String snowflakeCold = "assets/svg/wi-snowflake-cold.svg";
static const String solarEclipse = "assets/svg/wi-solar-eclipse.svg";
static const String sprinkle = "assets/svg/wi-sprinkle.svg";
static const String stars = "assets/svg/wi-stars.svg";
static const String stormShowers = "assets/svg/wi-storm-showers.svg";
static const String stormWarning = "assets/svg/wi-storm-warning.svg";
static const String strongWind = "assets/svg/wi-strong-wind.svg";
static const String sunrise = "assets/svg/wi-sunrise.svg";
static const String sunset = "assets/svg/wi-sunset.svg";
static const String thermometerExterior = "assets/svg/wi-thermometer-exterior.svg";
static const String thermometerInternal = "assets/svg/wi-thermometer-internal.svg";
static const String thermometer = "assets/svg/wi-thermometer.svg";
static const String thunderstorm = "assets/svg/wi-thunderstorm.svg";
static const String time1 = "assets/svg/wi-time-1.svg";
static const String time10 = "assets/svg/wi-time-10.svg";
static const String time11 = "assets/svg/wi-time-11.svg";
static const String time12 = "assets/svg/wi-time-12.svg";
static const String time2 = "assets/svg/wi-time-2.svg";
static const String time3 = "assets/svg/wi-time-3.svg";
static const String time4 = "assets/svg/wi-time-4.svg";
static const String time5 = "assets/svg/wi-time-5.svg";
static const String time6 = "assets/svg/wi-time-6.svg";
static const String time7 = "assets/svg/wi-time-7.svg";
static const String time8 = "assets/svg/wi-time-8.svg";
static const String time9 = "assets/svg/wi-time-9.svg";
static const String tornado = "assets/svg/wi-tornado.svg";
static const String train = "assets/svg/wi-train.svg";
static const String tsunami = "assets/svg/wi-tsunami.svg";
static const String umbrella = "assets/svg/wi-umbrella.svg";
static const String volcano = "assets/svg/wi-volcano.svg";
static const String windBeaufort0 = "assets/svg/wi-wind-beaufort-0.svg";
static const String windBeaufort1 = "assets/svg/wi-wind-beaufort-1.svg";
static const String windBeaufort10 = "assets/svg/wi-wind-beaufort-10.svg";
static const String windBeaufort11 = "assets/svg/wi-wind-beaufort-11.svg";
static const String windBeaufort12 = "assets/svg/wi-wind-beaufort-12.svg";
static const String windBeaufort2 = "assets/svg/wi-wind-beaufort-2.svg";
static const String windBeaufort3 = "assets/svg/wi-wind-beaufort-3.svg";
static const String windBeaufort4 = "assets/svg/wi-wind-beaufort-4.svg";
static const String windBeaufort5 = "assets/svg/wi-wind-beaufort-5.svg";
static const String windBeaufort6 = "assets/svg/wi-wind-beaufort-6.svg";
static const String windBeaufort7 = "assets/svg/wi-wind-beaufort-7.svg";
static const String windBeaufort8 = "assets/svg/wi-wind-beaufort-8.svg";
static const String windBeaufort9 = "assets/svg/wi-wind-beaufort-9.svg";
static const String windDeg = "assets/svg/wi-wind-deg.svg";
static const String windy = "assets/svg/wi-windy.svg";
